11111111
111100E1
1C000V11
111V0111
111000C1
1C0011P1
11111111
