111111111
100P00001
100C000E0
10000C001
111111111
